одурять	од.root-ур-а-ть	о-дур.root-а-ть
оловянник	олов.root-ан-ник
кюи	*кюи
понаучиться	по-науч.root-и-ть-ся
непраздничный	не-праздн.root-ичн-ой
высеребрить	вы-серебр.root-и-ть
арлекинада	арлекин.root-ад-а
вяхирь	*вяхирь
стройненький	стро.root-йн-еньк-ой	строй.root-н-еньк-ой
хвощ	хвощ.root
яснейший	ясн.root-ейш-ой
колочить	колоч.root-и-ть
рюмочка	рюм.root-очк-а
обручить	об-руч.root-и-ть
неверность	не-вер.root-ность	не-верн.root-ость
скончать	с-конч.root-а-ть
музей	музей.root
щеголеватый	щегол.root-еват-ой
россиянка	росс.root-иj-янк-а	росс.root-иян-к-а
армейский	арме.root-йск-ой	арм.root-ейск-ой	армей.root-ск-ой
сумбур	сумбур.root
брокгауз	бр.root-ок.root-гауз.root
изнашивать	из-наш.root-ива-ть
невестынька	невест.root-ын-j-к-а
приютное	приют.root-н-ое
битуин	би.root-ту.root-ин	бит.root-у-ин.root	бит.root-у-иj-н	бит.root-у.root-ин
дебет	дебет.root
разноименный	раз-но.root-им-енн-ой	разн.root-о-им.root-енн-ой	разн.root-о-имен.root-н-ой	разн.root-о-и.root-менн-ой
грамматик	граммат.root-ик
правительствующий	прав.root-итель-ств-у-ющ-ой
навигацкий	навиг.root-ацк-ой
плодотворнейший	плод.root-о-твор.root-н-ейш-ой
подозрить	подозр.root-и-ть
тетеревеять	тетер.root-ев-о-я.root-ть	тетер.root-о-ве.root-а-ть
свияжский	с-ви.root-аж-ск-ой
завсегдашний	за-всегда.root-шн-ой
забросать	за-брос.root-а-ть
заклать	за-кла.root-ть
концевой	конц.root-ев-ой
прихватывать	при-хват.root-ыва-ть
проигумен	про-игумен.root
гаррик	гар.root-ор-ик
боровок	боров.root-ок
прынц	*прынц
варшава	вар.root-шав.root-а
содрагаться	со-драг.root-а-ть-ся
шивороток	шиворот.root-ок
бонмо	*бонмо
перевидеть	пере-вид.root-е-ть	пере-в-иде.root-ть
ослепиться	о-слеп.root-и-ть-ся	осл.root-о-пи.root-ть-ся
пройма	пройм.root-а
шивэй	шив.root-эй.root
вопль	вопль.root
цырюльник	цы.root-ор-ю-льник
петулант	пет.root-уль-ант	пет.root-ул-ант
своевольствовать	сво.root-о-воль.root-ствова-ть
орясина	о-ряс.root-ин-а
выходка	вы-ход.root-к-а
перестреливаться	пере-стрел.root-ива-ть-ся
прогоны	про-гон.root-ы
пьфа	*пьфа
мужать	муж.root-а-ть
вересаев	*вересаев
скулить	скул.root-и-ть
гораздо	горазд.root-о
филимонович	фил.root-им-он-ович
обессилить	о-бес-сил.root-и-ть
скромность	скромн.root-ость
благовоннейший	благ.root-о-вон.root-н-ейш-ой	благ.root-ов-он-н-ейш-ой	благ.root-ов.root-онн-ейш-ой
правдолюбивый	правд.root-о-люб.root-ив-ой
вестимый	вест.root-им-ой
людный	люд.root-н-ой
козлиный	козл.root-ин-ой
скамеечка	скам.root-ейк-к-а	скам.root-еj-ечк-а
мышечный	мышеч.root-н-ой	мыш.root-ечн-ой
мужичишка	муж.root-ич-ишк-а
тамаша	там.root-аш-а
переодеванье	пере-од.root-ева-ниj-о	пере-од.root-о-вань.root-о	пере-о-де-вань.root-о
буланый	булан.root-ой
вакация	вак.root-ациj-а
свечение	свеч.root-ениj-о
дистаночный	дистан.root-очн-ой
пустеть	пуст.root-е-ть
каруца	кар.root-у-ц-а
темно-желтый	темн.root-о-желт.root-ой
авторитетный	автор.root-итет-н-ой
сассанид	сас.root-сан.root-ид.root
крепчать	крепч.root-а-ть
потрясающий	по-тряс.root-а-ющ-ой
отселев	от-сел.root-ов	от-сел.root-ев
докука	до-кук.root-а
счищать	с-чищ.root-а-ть
ославиться	осл.root-ав-и-ть-ся	о-слав.root-и-ть-ся	осл.root-ави.root-ть-ся
наминать	на-мин.root-а-ть
резюме	резюм.root-о
сердаба	серд.root-а-б-а
вакуф	*вакуф
длинноголовый	длин.root-н-о-голов.root-ой
причуда	при-чуд.root-а
объятье	об-я.root-тиj-о	об-ят.root-j-о
пелехинец	пел.root-ох-инец
катнуть	кат.root-ну-ть
тред-юнионистский	тред.root-юнион.root-ист-ск-ой
зонтичный	зонт.root-ичн-ой
мцырь	м.root-цы.root-рь.root
кровавый	кровав.root-ой
краина	кра.root-ин-а
награжденье	на-гражд.root-ениj-о
всепобедный	вс.root-о-побед.root-н-ой	вс.root-о-по-бедн.root-ой
вышеисчислить	выш.root-о-ис.root-числ.root-и-ть
растранжирить	рас-транжир.root-и-ть
электропроводность	электр.root-о-про-вод.root-ность
съязвить	с-язв.root-и-ть
прислание	при-сла.root-ниj-о	при-сл.root-аниj-о
адмиралтейский	адмиралт.root-еj-йск-ой	адмиралт.root-ей-ск-ой
эльдорадо	*эльдорадо
облеплять	об-лепл.root-а-ть
настрого	на-строг.root-о
слич	с-лич.root	сл.root-ич
благоугождать	благ.root-о-у-гожд.root-а-ть
впух	в-пух.root
молчанов	молч.root-ан-ов
таскать	тас.root-ка-ть	таск.root-а-ть
брибри	бри.root-бр.root-и	бри.root-бри.root
блиндировать	блин.root-д-ирова-ть
шереметевой	ше.root-ре-мет.root-ев-ой
храмовой	храм.root-ов-ой
деверие	дев.root-ериj-о	девер.root-иj-о
резо	рез.root-о
чаплин	ча.root-пл.root-ин
яран	яр.root-ан
фабрикантик	фабрик.root-ант-ик
толковитый	толк.root-овит-ой
вовнутрь	во-в-нутрь.root
предъявитель	пред-яв.root-итель
доехать	до.root-ох-а-ть	до-ех.root-а-ть	до.root-о-ха.root-ть
сага	саг.root-а
бердский	берд.root-ск-ой
привозной	при-во-зн.root-ой	при-воз.root-н-ой	пр.root-ив-озн-ой
ярл	яр.root-л
наказать	на-каз.root-а-ть
перемутить	пере-мут.root-и-ть
чернить	черн.root-и-ть
поспешнейший	по-сп.root-ешн-ейш-ой	по-спе.root-шн-ейш-ой	по-спеш.root-н-ейш-ой
тошнехонько	тошн.root-ох-оньк-о
трис	*трис
внятный	в-нят.root-н-ой	вн.root-ат-н-ой
жоди	*жоди
фехтовать	фехт.root-ова-ть
икорка	икор.root-к-а
исколесить	ис-колес.root-и-ть
мэйю	*мэйю
молдава	мол.root-дав.root-а
романов	роман.root-ов
вырастить	вы-раст.root-и-ть
парадер	парад.root-ор	парад.root-ер
искалечение	ис-калеч.root-ениj-о
искуснейший	искус.root-н-ейш-ой
каппадокия	кап.root-па-до-ки.root-а	кап.root-пад.root-о-ки.root-а
миролюбный	мир.root-о-люб.root-н-ой
преминовать	пре-мин.root-ова-ть	прем.root-ин-ова-ть
межпольный	меж-по.root-льн-ой	меж-поль.root-н-ой	меж-по-льн.root-ой
долбежник	долб.root-еж-ник
перхун	перх.root-ун
авдитор	а-в-дит.root-ор
квиэтизм	кв.root-и.root-эт.root-изм
буфет	буфет.root
туша	туш.root-а
эршыский	*эршыский
дрожка	дрож.root-к-а
садко	сад.root-к-о
левок	лев.root-ок
подвздошный	под-вз-дош.root-н-ой	под-вз-до.root-шн-ой
афанасьевич	*афанасьевич
калибр	калибр.root
добровский	добр.root-овск-ой
бестуманный	бес-туман.root-н-ой
закладеный	за-клад.root-ен-ой
гонительница	гон.root-итель-ниц-а
ручонка	руч.root-онк-а
выжечь	вы-жечь.root	вы-же.root-чь
конкубинат	кон.root-куб.root-ин-ат
гермейстер	г.root-ер.root-мейстер
приятнейший	прият.root-н-ейш-ой
кокон	кокон.root
изящный	изящ.root-н-ой
мильтонов	мильт.root-он-ов
тепесь	*тепесь
дешт	*дешт
истребитель	истреб.root-итель
безъякорный	без-якор.root-н-ой
суеверье	су.root-о-верь.root-о	суе.root-верь.root-о
маслице	масл.root-иц-о
надсматривать	над-сматр.root-ива-ть
арсенал	арсенал.root
кристаллоидный	кристалл.root-оид-н-ой
пароксизм	парокс.root-изм
барышничество	барыш.root-ник-еств-о
беспутство	бес-пут.root-ств-о
дойт	*дойт
пудовой	пуд.root-ов-ой
дурман	дурман.root
биржевик	бирж.root-евик
этилмолочная	этил.root-мол.root-очн-ая	этил.root-молоч.root-н-ая
ученица	уч.root-ениц-а
журьба	журь.root-б-а
пригоршня	при-горш.root-н-а
слюда	слюд.root-а
салакушка	салак.root-ушк-а
высвободить	вы-свобод.root-и-ть
уживаться	уж.root-ива-ть-ся
общественный	общ.root-е-ственн-ой	общ.root-еj-ственн-ой	общ.root-еств-енн-ой
соперничать	сопер.root-нича-ть
баловство	бал.root-овств-о	балов.root-ств-о
дрезден	дрез.root-ден.root	дрез.root-д-ен
модник	мод.root-ник
объезжать	об-езж.root-а-ть
аладжа	а-лад.root-жа.root
маркиз	марк.root-из.root
массивный	масс.root-ивн-ой
дрын	др.root-ын.root
мягчить	мягч.root-и-ть
мейсен	*мейсен
втайне	в-тайн.root-о
распоясовский	рас-пояс.root-овск-ой
посредством	по-сред.root-ств-ом
напруживаться	на-пруж.root-ива-ть-ся	напр.root-уж-ива-ть-ся
мирочка	мир.root-очк-а
покон	по-кон.root	поко.root-н
глазенки	глаз.root-енк-и
упаковка	у-пак.root-овк-а
возлетать	воз-лет.root-а-ть	возле.root-т-а-ть	возле.root-та.root-ть
искорский	искор.root-ск-ой
зачуять	за-чу.root-а-ть
зеленек	зел.root-енек
каменноугольный	камен.root-н-о-уголь.root-н-ой	ка.root-менн-о-уголь.root-н-ой	кам.root-енн-о-уголь.root-н-ой
вожан	вож.root-ан
таить	та.root-и-ть
переоценивать	пере-о-цен.root-ива-ть
гадливый	гад.root-лив-ой
треска	треск.root-а
цензорство	ценз.root-ор-ств-о
садзаглихевский	сад.root-за-г.root-л-их-евск-ой
проччие	*проччие
упущенье	у-пущ.root-ениj-о
перебежать	пере-беж.root-а-ть
златник	зл.root-атник	злат.root-ник
малаховский	мал.root-ах-овск-ой
кедровник	кедр.root-овник
усадьба	усадьб.root-а
насидеть	на-с-иде.root-ть	на-сид.root-е-ть
благоусмотрение	благ.root-о-у-смотр.root-ениj-о
пиластр	пил.root-астр.root
каляканье	каляк.root-а-ниj-о	каляк.root-ан-j-о
томление	томл.root-ениj-о
отлогость	от-лог.root-ость
очаровать	о-чар.root-ова-ть
вешить	веш.root-и-ть
ветчинка	ветчин.root-к-а
похолоделый	по-холод.root-ел.root-ой	по-холод.root-еj-л-ой	по-хол.root-о-дел.root-ой	по-холо.root-дел.root-ой	по-холод.root-е-л-ой
тифинец	тиф.root-инец
замазывать	за-маз.root-ыва-ть
сторожиха	сторож.root-их-а
послеобед	после-обед.root
прослезить	про-слез.root-и-ть
непрямой	не-прям.root-ой
корфиот	*корфиот
вун	в-ун.root
изобильнейший	из.root-об-ильн-ейш-ой	из-обиль.root-н-ейш-ой	изо.root-б-ильн-ейш-ой	из-об.root-ильн-ейш-ой	изо-би.root-льн-ейш-ой
оди	од.root-и
переплавка	пере-пл.root-авк-а
каррак	кар.root-рак.root
пошлость	пошл.root-ость
подустить	под-уст.root-и-ть	под-у-сти.root-ть
аудиенц-зал	аудиенц.root-зал.root
евгеньевич	*евгеньевич
выгрузить	вы-груз.root-и-ть
бабник	баб.root-ник
рябиновка	ряб.root-ин-овк-а
бестактность	бес-такт.root-ность
элевзинский	элев.root-зин.root-ск-ой
хоувиза	*хоувиза
вплестись	в-пле.root-сти-ся	в-плес.root-ти-ся
расфрантиться	рас-франт.root-и-ть-ся
бисер	бисер.root
кхи	*кхи
оголеть	о-гол.root-е-ть
пансионный	панс.root-ионн-ой
люнебургский	*люнебургский
женочка	жен.root-очк-а
восьмидесятник	восьми.root-десят.root-ник	восьми.root-дес.root-ятник
угадчик	уг.root-ад-чик
обменный	об.root-менн-ой
сяньбиец	*сяньбиец
загорбок	за-горб.root-ок
любимчик	люб.root-им-чик
замечаться	зам.root-о-ча.root-ть-ся	за-меч.root-а-ть-ся
леокадить	ле.root-ок-ад-и-ть
субординация	суб-ордин.root-ациj-а
слащавость	слащ.root-ав-ость
распростираться	рас-простир.root-а-ть-ся
неподложный	не-под-ложн.root-ой
скачки	скач.root-к-и
ружейник	руж.root-ей-ник
анштет	*анштет
сцепиться	с-цеп.root-и-ть-ся
возвесть	воз-ве.root-сть	воз-весть.root	воз-вес.root-ть
бесписьменность	бес-письм.root-ен-ность	бес-письм.root-е-нность	бес-пись.root-менн-ость	бес-письм.root-енн-ость
домоправительница	дом.root-о-прав.root-итель-ниц-а
мэрия	мэр.root-иj-а
фикельмон	*фикельмон
поопериться	по-опер.root-и-ть-ся
попахнуть	по-пах.root-ну-ть	поп.root-ах-ну-ть
остав	о-став.root	ост.root-ав
маличка	мал.root-ичк-а
компрометироваться	компромет.root-ирова-ть-ся
собачей	собач.root-ей
кляузник	кляуз.root-ник
коры	кор.root-ы
горохов	горох.root-ов
гексаметиленамин	г.root-ек.root-сам.root-о-тил.root-о-на-мин.root
ядох	я.root-дох.root	яд.root-ох.root
адья	ад.root-j-а
свиданье	с-вид.root-ан-j-о	с-вид.root-а-ниj-о
сурков	сурк.root-ов
л	*л
кордуанский	кор.root-ду.root-анск-ой
прирожденный	при-рожд.root-енн-ой
политехнический	полит.root-ох-н-ическ-ой
потчевание	потч.root-ева-ниj-о
жирник	жир.root-ник
гэ	*гэ
неисследованный	не-исследова.root-н-н-ой
несоответствие	не-со-ответ.root-ствиj-о	нес.root-о-ответ.root-ствиj-о
разительнейший	раз.root-ительн-ейш-ой
анатолийский	анат.root-ол-ийск-ой
приражение	при-раж.root-ениj-о
ржавый	ржав.root-ой
самонадеяние	сам.root-о-наде.root-аниj-о
бездарнейший	без-дар.root-н-ейш-ой
рассовывать	рас-сов.root-ыва-ть
дук	дук.root
белосток	бел.root-ост-ок
пресытиться	пре-сыт.root-и-ть-ся
лавный	лав.root-н-ой
партикулярный	пар.root-тик.root-ул.root-ар-н-ой	пар.root-тик.root-ул-а-ор-н-ой	парт.root-и-к-ул-а-ор-н-ой	парт.root-и.root-кул.root-ар-н-ой	парт.root-ик.root-ул-а-ор-н-ой	пар.root-тик.root-уль-а-ор-н-ой	пар.root-тиj-к-ул-а-ор-н-ой	парт.root-ик-у-л-а-ор-н-ой	парт.root-ик.root-ул.root-ар-н-ой	парт.root-ик.root-уль-а-ор-н-ой	парт.root-иj-к-ул-а-ор-н-ой
метиленмалоновый	мет.root-и.root-лен.root-мал.root-о-нов.root-ой	мет.root-и.root-лен.root-мал.root-он-ов-ой
надумываться	над.root-ум-ыва-ть-ся	на-дум.root-ыва-ть-ся	над-ум.root-ыва-ть-ся
анджело	*анджело
альт	альт.root
каприз	каприз.root
кохрить	*кохрить
шельмовый	шельм.root-ов-ой
пошатнуться	по-шат.root-ну-ть-ся
гуминовый	гум.root-ин-ов-ой
отбить	от-би.root-ть
ляс	ляс.root
воздвиженье	воз-движ.root-ениj-о
каютка	ка.root-ютк-а	кают.root-к-а
месяц	месяц.root
волчец	волч.root-ец
всесовершеннейший	вс.root-о-совершен.root-н-ейш-ой
францыля	*францыля
котур	кот.root-у-ор	ко.root-тур.root	кот.root-ур.root
рахманов	*рахманов
морельщик	море.root-льщик
крачка	крачк.root-а
цензурный	ценз.root-ур-н-ой
отчас	от-час.root
диметилглутаровой	*диметилглутаровой
посвятить	по-свят.root-и-ть
зоил	зо.root-иj-л	зо.root-ил.root
хоур	*хоур
подобиться	подо-би.root-ть-ся	подоб.root-и-ть-ся
толсто	толст.root-о
тримурти	три.root-мур.root-ти
врачеваться	врач.root-ева-ть-ся
предовольно	пре-доволь.root-н-о	предо-во-льн.root-о	предо-воль.root-н-о
кошева	кош.root-ив-а	кош.root-ев-а
выглянуть	в-ыгл.root-ану-ть	вы-гля.root-ну-ть
мазать	маз.root-а-ть
асп	а-сп.root
повстание	повстан.root-иj-о
трясти	тряс.root-ти
центавр	центавр.root
благорастворение	благ.root-о-рас-твор.root-ениj-о
унция	унци.root-а
немерный	не-мер.root-н-ой	нем.root-ер-н-ой	нем.root-ор-н-ой
курятный	кур.root-ат-н-ой
подвесок	под-вес.root-ок
подлинность	подлинн.root-ость
протальбовый	про-таль.root-б-ов-ой
подтрунивать	под-трун.root-ива-ть
отсель	от-сель.root
насыщение	на-сыщ.root-ениj-о
алиберовский	а-либер.root-овск-ой
пенсионерка	пенс.root-ион-ер-к-а	пенси.root-онер-к-а
аничковский	ан.root-ичк-овск-ой
лектриса	лект.root-ор-ис-а
павший	па-вш.root-ой	па.root-вш-ой
джаное	*джаное
ганзеец	ган.root-зе.root-ец
задавать	за-дав.root-а-ть	за-да.root-ва-ть	зад.root-ав-а-ть
по-хозяйски	по-хозяй.root-с-к-и
примечать	при-меч.root-а-ть	прим.root-о-ча.root-ть
христинка	христ.root-инк-а
тугурский	туг.root-ур-ск-ой
жить	жить.root	жи.root-ть
подлог	под-лог.root
прозрачно	про-зрач.root-н-о
любление	любл.root-ениj-о
рыжебородый	рыж.root-о-бород.root-ой
джарить	*джарить
гордец	горд.root-ец
сиах	си.root-ах.root
монпелье	мон.root-пель.root-о
поминальщик	помин.root-ал-щик	помин.root-аль-щик
вукалеонский	в-у-кал.root-о-о.root-нск-ой	в-ук.root-ал-е-он-ск-ой	в-у-кал.root-е-он-ск-ой
атлетически	атлет.root-ич-е-с-к-и
копер	копер.root
наилучше	наи-лучш.root-о
нечаевец	не-ча.root-ив-ец
институт	институт.root
сговорный	с-говор.root-н-ой	с-гов.root-орн-ой
генералка	генерал.root-к-а
сортировка	сорт.root-ир-овк-а
вадбольский	вад.root-боль.root-ск-ой
поразительнейший	по-раз.root-ительн-ейш-ой
неблагонравие	не-благ.root-о-нрав.root-иj-о
росписать	рас-пис.root-а-ть
сероватый	сер.root-оват-ой
бригадирский	бригад.root-ир-ск-ой
безгрешно	без-греш.root-н-о
преглупо	пре-глуп.root-о
отметчик	от-мет.root-чик
апробация	апроб.root-ациj-а
согласная	со-глас.root-н-ая
кадушкин	кад.root-ушк-ин
судия	суд.root-иj-а
инст	ин.root-ст.root
увеличиться	у-велич.root-и-ть-ся
копнить	копн.root-и-ть
развратитель	разврат.root-итель
отпуск	от-пуск.root
преемница	пре-ем.root-ниц-а
заворовать	за.root-вор-ова-ть	зав.root-ор-ова-ть	за-во-рова.root-ть	за-вор.root-ова-ть	зав.root-о-рова.root-ть
словянский	слов.root-янск-ой
казусный	казус.root-н-ой
ацетонилацетон	*ацетонилацетон
полином	поли.root-ном.root	пол.root-ин-ом	по-лин.root-ом	пол-ин.root-ом	поли.root-н-ом
сочинительский	сочин.root-итель-ск-ой	сочин.root-и-тельск-ой
чрево	чрев.root-о
приамурье	при-амур.root-j-о
крестовик	крест.root-овик
зигзаг	зигзаг.root
бразды	бразд.root-ы
одноличный	одн.root-ол-ичн-ой	одн.root-о-личн.root-ой
низехонький	низ.root-ох-оньк-ой
заключение	за-ключ.root-ениj-о
смыкание	с-мык.root-аниj-о
возмогать	воз-мог.root-а-ть
вселять	вс-ел.root-а-ть	в-сел.root-а-ть	вс.root-ель-а-ть
просфирка	*просфирка
обожать	обожа.root-ть
чжисяня	*чжисяня
полить	поли.root-ть
охлопья	о-хлопь.root-а
невьянский	не-вь.root-янск-ой
ундольский	ун.root-доль.root-ск-ой
зачаровать	за-чар.root-ова-ть
кречетка	кречет.root-к-а
повторить	по-втор.root-и-ть
терпеть	терп.root-е-ть
остроумнейший	о-стро.root-ум-н-ейш-ой	остр.root-о-у-мн.root-ейш-ой	остр.root-о-ум.root-н-ейш-ой
контрмина	контр-мин.root-а
резюмировать	резюм.root-ирова-ть
грезовский	грез.root-овск-ой
бичеванье	бич.root-ева-ниj-о	бич.root-о-вань.root-о
миостром	мио.root-стром.root	ми.root-о-стром.root
донауверт	до-на-у-верт.root
адамит	а-дам.root-ит
магнолия	магноли.root-а
перехватить	пере-хват.root-и-ть
спешно	спеш.root-н-о
шишимора	шиш.root-им-о-ра.root
миг	миг.root
верющий	вер.root-ющ-ой
муштегид	муш.root-т-о-г.root-ид.root
норец	нор.root-ец
таевец	та.root-ив-ец
крестненька	крест.root-н-оньк-а
завтрак	завтрак.root
эмансипировать	эман.root-сип.root-ирова-ть
солоноватый	сол.root-он-оват-ой	со-лон.root-оват-ой	соло.root-н-оват-ой
киянин	ки.root-ан-ин
индуктория	ин.root-дук.root-тор.root-иj-а	ин.root-дук.root-т-о-ри.root-а
диметилпимелиновый	*диметилпимелиновый
кержачонок	кер.root-жа.root-чонок
сглаживать	с-глаж.root-ива-ть
выставочный	вы-став.root-очн-ой
корнелий	корн.root-ел.root-ой	корн.root-ель-ой
фильмовый	фильм.root-ов-ой
цитрус	цитрус.root
биокосный	био.root-косн.root-ой	би.root-о-косн.root-ой
хлебопашец	хлеб.root-о-паш.root-ец
монинг	мон.root-инг
осуществлять	осуществл.root-а-ть
побежка	по-беж.root-к-а
людоедство	люд.root-о-ед.root-ств-о
ландштурмист	ланд.root-штурм.root-ист
скатиться	с-кат.root-и-ть-ся
кронштадской	*кронштадской
неблагообразный	не-благ.root-о-образ.root-н-ой	не-благ.root-о-об-разн.root-ой
помза	пом.root-за.root
сморкач	сморк.root-ач
сварочный	свар.root-очн-ой
подъездной	под-езд.root-н-ой
моторизовать	мотор.root-изова-ть
анжелос	ан.root-же.root-лос.root	ан.root-жел.root-ос.root
ревельский	рев.root-ель-ск-ой
любей	люб.root-ей
обить	о-би.root-ть	об.root-и-ть	об-и.root-ть
иезо	и.root-о-зо.root
пробер	проб.root-ер	проб.root-ор	про-бер.root
аминомасляный	амин.root-о-масл.root-ян-ой
геркулесовец	г.root-ерк-у-л-о-сов.root-ец
моршанск	*моршанск
ирк	ир.root-к
центробежность	центр.root-о-беж.root-ность
раскусать	рас-кус.root-а-ть
коксовый	кокс.root-ов-ой
зыблиться	зыбл.root-и-ть-ся
кувырнуться	кувыр.root-ну-ть-ся
всев	вс.root-ев	в-сев.root	вс.root-ов
пересоздание	пере-созд.root-аниj-о
севец	сев.root-ец
ситро	ситро.root
правосознание	пра-во-созна.root-ниj-о	прав.root-о-созна.root-ниj-о
заняться	за-ня.root-ть-ся
контрреволюционный	контр-революц.root-ионн-ой
вискоза	вискоз.root-а
захохотать	за-хохот.root-а-ть
едор	ед.root-ор
осмотреться	осм.root-о-тре.root-ть-ся	о-смотр.root-е-ть-ся
ясно	ясн.root-о
милюк	*милюк
коростеньский	корост.root-ень-ск-ой	корост.root-ениj-ск-ой
пристановка	при-стан.root-овк-а
кульмский	ку.root-ль.root-м.root-ск-ой
игуменья	игумен.root-j-а
пискливый	писк.root-лив-ой
маратовец	марат.root-овец
расстригать	рас-стриг.root-а-ть
поддерживаться	под-держ.root-ива-ть-ся
липучка	лип.root-у-чк-а	лип.root-уч-к-а
гречаный	греч.root-ан-ой
подхлестывание	под-хлест.root-ыва-ниj-о
увлечь	у-вле.root-чь
вкатить	в-кат.root-и-ть
светок	свет.root-ок
празднество	праздн.root-еств-о
сопнуть	соп.root-ну-ть
кухарь	кух.root-арь
дивья	див.root-j-а
шакал	шакал.root
эрепсин	эр.root-о-пс.root-ин
коко	кок.root-о
моральность	мораль.root-ность
мукачевский	мук.root-ач-евск-ой
лошадушка	лошад.root-ушк-а
павлон	павл.root-он
обогатить	о-богат.root-и-ть	обо-гат.root-и-ть
сольца	соль.root-ц-а
супротивный	су-против.root-н-ой
усечка	ус.root-ечк-а
марионеточный	марионет.root-очн-ой
рсфср	*рсфср
размалываться	раз-мал.root-ыва-ть-ся
верхом	верх.root-ом
пунцовый	пунц.root-ов-ой
желаемый	жела.root-ем-ой
движимость	движ.root-имость
толстозадый	толст.root-о-зад.root-ой
самозамкнутость	сам.root-о-за-мк.root-ну-тость	сам.root-о-зам.root-кнут.root-ость	сам.root-о-зам.root-к-ну-тость
вуазный	в-у-а-зн.root-ой	в-у-аз.root-н-ой
линовать	лин.root-ова-ть
спечь	спе.root-чь
бенгази	бен.root-газ.root-и
льзя	*льзя
чернобровый	черн.root-о-бров.root-ой
газолин	газ.root-ол-ин	газ.root-о-лин.root
квартирмейстер	квартир.root-мейстер
божев	бож.root-ов	бож.root-ев
техминимум	тех.root-миним.root-ум
непечатный	не-печат.root-н-ой
кин	кин.root
тэт	*тэт
кровожадность	кров.root-о-жад.root-ность
маскщит	маск.root-щит.root
малевать	мал.root-ева-ть	малев.root-а-ть
такт	такт.root
мрачный	мрач.root-н-ой
дополна	до-полн.root-а
стыр	стыр.root
мизгирь	миз.root-гирь.root
австрофильский	австр.root-о-филь.root-ск-ой
иисусик	и.root-ис-у-с-ик	и.root-ис.root-ус-ик
черепенников	череп.root-енн-ик-ов	череп.root-ен-ник-ов
рры	*рры
элегик	*элегик
бетонщица	бетон.root-щиц-а
мось	м.root-ось.root
манхадать	ман.root-ха.root-д-а-ть	ман.root-ха.root-да.root-ть
обсеменять	об-семен.root-а-ть
категориальный	категор.root-иальн-ой
диагностика	диагност.root-ик-а
дозировать	доз.root-ирова-ть
темноцветный	темн.root-о-цвет.root-н-ой
пронырство	про-ныр.root-ств-о
нагчить	наг.root-ч-и-ть
убойный	у-бо.root-йн-ой	у-бой.root-н-ой
дебелый	дебел.root-ой
незаглушить	не-за-глуш.root-и-ть
непроходить	не-про-ход.root-и-ть
проталкивание	про-талк.root-ива-ниj-о
бумажка	бумаж.root-к-а
углить	угл.root-и-ть
вдвигаться	в-двиг.root-а-ть-ся
детдвижение	дет.root-движ.root-ениj-о
первоначально	перв.root-о-началь.root-н-о
хилиаст	хил.root-иj-аст
возврат	воз-врат.root
сарны	сар.root-н-ы
сверхкачественный	сверх-качеств.root-енн-ой
выбрасывать	вы-брас.root-ыва-ть
мурлычить	мурл.root-ыч-и-ть
пастернак	пастернак.root
бюргерство	бюргер.root-ств-о
вышитый	вы-ши.root-т-ой	выш.root-и-т-ой
ручьевой	ручь.root-ев-ой
экзаминатор	экзамин.root-атор
шпор	шпор.root
жезлоносец	жезл.root-о-нос.root-ец
казна	казн.root-а
осьнадцатый	ось.root-надцат.root-ой
разнобойный	разнобой.root-н-ой
порося	порос.root-а
монолитность	монолит.root-ность
напереди	на-перед.root-и
затемниться	за-темн.root-и-ть-ся
уксюб	*уксюб
продажный	прод.root-аж-н-ой	про-даж.root-н-ой
екатеринославский	екатерин.root-о-слав.root-ск-ой	екатерин.root-о-сла.root-вск-ой
дошутиться	до-шут.root-и-ть-ся	дош.root-ут-и-ть-ся
удовлетворенность	удовлетвор.root-енн-ость	удовлетвор.root-е-нность	удовлетвор.root-ен-ность
причудливейший	при-чуд.root-лив-ейш-ой
девчурка	дев.root-ч-ур-к-а
вывесочный	вы-вес.root-очн-ой
гарднер	гард.root-н-е-ор	гар.root-дн.root-ер	гард.root-не.root-ор	гар.root-дн.root-ор
манжурия	ман.root-жур.root-иj-а
остинка	ост.root-инк-а
каскар	кас.root-кар.root	кас.root-ка-ор
этилалкоголь	этил.root-алкоголь.root
барра	бар.root-ра.root
литургия	литург.root-иj-а
посовать	пос.root-ова-ть
завладевать	за-влад.root-ева-ть
басаврюк	*басаврюк
картиночка	картин.root-очк-а
пчелка	пчел.root-к-а
раба	раб.root-а
отрыгать	от-рыг.root-а-ть
римл	рим.root-л
обтяжка	обт.root-аж-к-а	об-тяж.root-к-а
мщение	мщ.root-ениj-о
шимми	ши.root-м.root-м.root-и	ши.root-м.root-ми.root
делайт	*делайт
закапывать	за-кап.root-ыва-ть
товарищеский	товарищ.root-еск-ой
показанье	по-каз.root-а-ниj-о	по-каз.root-ан-j-о	пока.root-за.root-ниj-о
отпадение	от-пад.root-ениj-о
сенин	се.root-нин	сен.root-ин
одряблеть	о-дрябл.root-е-ть
молонья	мол.root-он-j-а
неповиновение	не-по-вино.root-в-е-ниj-о	не-по-вин.root-ов.root-ениj-о	не-по-вин.root-ов-о-ни.root-о	не-по-вин.root-о-вен.root-иj-о	не-п.root-овин-ов-е-ниj-о	не-по-вин.root-ов-е-ниj-о	не-п.root-овин-ов-о-ни.root-о	не-по-ви.root-нов.root-ениj-о	не-по-вин.root-о-ве.root-ниj-о	не-по-вино.root-ве.root-ниj-о	не-по-вино.root-вен.root-иj-о
инкерманский	ин.root-кер.root-ман-ск-ой
огневаться	огн.root-ева-ть-ся
угашение	у-гаш.root-ениj-о
темпераментно	темперамент.root-н-о
кормик	корм.root-ик
лефортовский	ле.root-форт.root-овск-ой
сафар	с-а-фар.root
обуржуазивание	о-буржуаз.root-ива-ниj-о
боеревком	бо.root-о-рев.root-ком.root	бо.root-о-ре-в-ком.root	бо.root-ер-ев-к-ом	бо.root-ор-ев-к-ом	бо.root-о-рев.root-к-ом
центна	цент.root-н-а
трусов	трус.root-ов
долбежка	долб.root-еж-к-а
общеслав	общ.root-о-слав.root
двуглавый	дву.root-глав.root-ой
слагаться	сл.root-аг-а-ть-ся	с-лаг.root-а-ть-ся
геранцев	ге.root-ор-ан-ц-ев	ге.root-ран.root-ц-ов	г.root-ер-ан-ц-ов	ге.root-ран.root-ц-ев	г.root-ер-ан-ц-ев	ге.root-ран.root-цев.root	ге.root-ор-ан-ц-ов	г.root-о-ран.root-ц-ев	г.root-ор-ан-ц-ов	г.root-о-ран.root-ц-ов	г.root-ор-ан-ц-ев	г.root-о-ран.root-цев.root
ферментироваться	фермент.root-ирова-ть-ся
суперрегенеративный	супер-ре-генер.root-ат-ивн-ой
серебряковский	серебр.root-як-овск-ой	серебр.root-ак-овск-ой
мобилизоваться	мобил.root-изова-ть-ся
водоносный	во-дон.root-о-сн.root-ой	во-до-нос.root-н-ой	вод.root-о-нос.root-н-ой
нужный	нуж.root-н-ой
бычий	быч.root-ой
печечка	печ.root-ечк-а
фосфор	фосфор.root
демьянов	дем.root-j-а-н-ов
добряк	добр.root-як	до-бряк.root	добр.root-ак
сатурналии	сатурн.root-а-ли.root-и	сатурн.root-ал.root-иj-и
изготовляться	из-готовл.root-а-ть-ся
мозжечковый	мозж.root-ечк-ов-ой
сутенерство	су-тен.root-ор-ств-о	су-тен.root-ер-ств-о
лепсиус	леп.root-си.root-ус.root	лепс.root-и.root-ус.root
зябкость	зяб.root-к-ость	зяб.root-ко.root-сть	зяб.root-кос.root-ть
бобэоби	боб.root-эо.root-б-и
лукашевка	лук.root-аш-ев-к-а
подмога	под-мог.root-а
евклид	евклид.root
малоземелье	мал.root-о-земель.root-о
никодимов	ник.root-од.root-им-ов	ни.root-код.root-им-ов
весь	весь.root
сматываться	с-мат.root-ыва-ть-ся
таки	так.root-и
самочка	сам.root-очк-а
помножать	по-множ.root-а-ть
семипудовый	семи.root-пуд.root-ов-ой
передыхать	пере-дых.root-а-ть
погрозиться	по-гроз.root-и-ть-ся
неостывать	не-ост.root-ыва-ть	не.root-ост-ыва-ть
родофиникин	род.root-о-фин.root-ик-ин
искровец	искр.root-овец
мэон	м.root-эо.root-н
блудов	блуд.root-ов
нечеловечность	не-человеч.root-ность
предвоенный	пред-во.root-енн-ой	пред-воен.root-н-ой	пре-дво.root-енн-ой
колоритный	колорит.root-н-ой
нервически	нерв.root-ич-е-с-к-и
госполитиздат	гос.root-полит.root-издат.root
иллюминатор	иллюмин.root-атор
газелла	газ.root-ел.root-л-а
адольф	*адольф
авиасоединение	авиа.root-соедин.root-ениj-о
запродажа	за-про-даж.root-а
преосвященство	пре-о-свящ.root-ен-ств-о	пре.root-о-свящ.root-ен-ств-о
медведка	медвед.root-к-а
любопытно	любопыт.root-н-о
подпортить	под-порт.root-и-ть
недоговаривать	недо-говар.root-ива-ть
разверстка	раз-верст.root-к-а
душетский	душ.root-от-ск-ой	душ.root-ет-ск-ой
талдомский	тал.root-дом.root-ск-ой
фаустовская	*фаустовская
масштабный	масштаб.root-н-ой
новочеркасский	нов.root-о-чер.root-ка-с-ск-ой	нов.root-о-чер.root-кас.root-ск-ой	нов.root-о-черк.root-а-с-ск-ой
опорожнить	о-порожн.root-и-ть
усердно	усерд.root-н-о
треф	*треф
птицевод	птиц.root-о-вод.root
постановление	постановл.root-ениj-о
нерассказанный	не-рас-сказ.root-ан-н-ой
жаба	жаб.root-а
раскидаться	рас-кид.root-а-ть-ся
ложбинка	лож.root-б-инк-а
хозрасчет	хоз.root-рас-чет.root
курдский	курд.root-ск-ой
поправочка	поп.root-рав-очк-а
левак	лев.root-ак
сгрудить	с-груд.root-и-ть
отцеубийца	отц.root-о-у-бий.root-ц-а
хлебозавод	хлеб.root-о-завод.root
темечко	тем.root-ечк-о
заступник	за-ступ.root-ник
изламываться	из-лам.root-ыва-ть-ся
изнуренный	из-нур.root-енн-ой
тихомолком	тих.root-о-молк.root-ом
седоволосый	сед.root-о-волос.root-ой
гомеопатически	гоме.root-о-пат.root-ич-е-с-к-и
шабек	*шабек
вычеркивать	вы-черк.root-ива-ть	выч.root-ерк-ива-ть
стюард	стюард.root
желчно	желч.root-н-о
агонистический	агон.root-истическ-ой
задышка	зад.root-ышк-а
боливар	бол.root-ива-ор
вытянуться	выт.root-ану-ть-ся
еланить	ел.root-ан-и-ть
гаечка	гаеч.root-к-а
бланко	бл.root-анк-о
лаговский	лаг.root-овск-ой
семковский	сем.root-к-овск-ой
ачуевский	а-чу.root-евск-ой
ладошка	ладош.root-к-а
подрамок	по-драм.root-ок	под-рам.root-ок
верисоцкий	ве.root-ри.root-соц.root-к-ой	вер.root-и.root-соц.root-кий.root	вер.root-и.root-соц.root-к-ой	ве.root-ри.root-соц.root-кий.root
папашенька	пап.root-аш-оньк-а
шарин	шар.root-ин
саморазряд	сам.root-о-раз-ряд.root
егорычев	егор.root-ыч-ов	егор.root-ыч-ев
молвить	молв.root-и-ть
пронумеровать	про-нумер.root-ова-ть
рекомендательный	рекоменд.root-ат-ельн-ой	рекоменд.root-а-тельн-ой
востоковедный	восток.root-ов-о-дн.root-ой	восток.root-о-вед.root-н-ой
премироваться	прем.root-ирова-ть-ся
интуит	интуит.root
выстрадать	вы-страд.root-а-ть
вороватый	вор.root-оват-ой
вселение	в-сел.root-ениj-о	вс-ел.root-ениj-о	в-селен.root-иj-о	вс-еле.root-ниj-о
приселить	при-сел.root-и-ть
сокоотделение	сок.root-о-от-дел.root-ениj-о
разрезывание	раз-рез.root-ыва-ниj-о	раз-ре-зыв.root-аниj-о
корявка	кор.root-явк-а
подбивать	под-би.root-ва-ть	под-бив.root-а-ть	под.root-б-ива-ть
бодягин	бод.root-яг-ин	бод.root-аг-ин
клушица	клуш.root-иц-а
восхищенный	вос-хищ.root-енн-ой
улахинский	ул.root-ах-инск-ой
бержеретта	бер.root-же.root-рет.root-та.root
парга	пар.root-г.root-а
восстание	вос-стан.root-иj-о	вос-ста.root-ниj-о	вос-ст.root-аниj-о
акушерский	акуш.root-ер-ск-ой	акуш.root-ор-ск-ой
кувыркать	кувыр.root-ка-ть
пересаживать	пере-саж.root-ива-ть
похлебка	по-хлеб.root-к-а
орлиный	орл.root-ин-ой
блокировочный	блок.root-ир-овк-н-ой
шубенка	шуб.root-енк-а
отбрехиваться	от-брех.root-ива-ть-ся
раздеванье	раз-де-вань.root-о
слободно	слобод.root-н-о
раздражитель	раз-драж.root-итель
откормленный	от-кормл.root-енн-ой
ротативный	рот.root-ат-ивн-ой
никкель	ник.root-к-ель
утес	утёс.root
электрооборудование	электр.root-о-об-оруд.root-ованиj-о
рецидивист	рецидив.root-ист
генрихович	ген.root-ор-их-ович
бельецо	бель.root-ец-о
богадельщик	бог.root-ад-е-льщик
магдалинский	маг.root-дал.root-инск-ой
черкануть	черк.root-ану-ть
гарантировать	гарант.root-ирова-ть
сапка	сап.root-к-а
первопечатник	перв.root-о-печат.root-ник	перв.root-о-печ.root-атник
стрез	ст.root-рез.root
радиопроизводство	радио.root-про-из-вод.root-ств-о	ради.root-о-про-из-вод.root-ств-о
леккой	лек.root-кой.root
премудрый	пре-мудр.root-ой
заушение	за-уш.root-ениj-о
судопроизводство	су-до-про-из-вод.root-ств-о	суд.root-о-про-из-вод.root-ств-о
доброармия	добр.root-о-арм.root-иj-а
въездной	в-езд.root-н-ой
пересуды	пере-суд.root-ы
демятинский	дем.root-ат-инск-ой	де-мят.root-инск-ой
яслиска	ясл.root-ис-к-а
штандартный	штан.root-да.root-рт.root-н-ой
колосовой	колос.root-ов-ой
штой	*штой
непрописанный	не-про-пис.root-ан-н-ой
кротчайший	кротч.root-айш-ой
блинная	блин.root-н-ая
примиренческий	при-мир.root-ен-ческ-ой
ным	ны.root-м.root
эпирский	эпи.root-ор-ск-ой	эп.root-ир-ск-ой
слезный	сл.root-езн-ой	слез.root-н-ой
набиваться	на-би.root-ва-ть-ся	на-бив.root-а-ть-ся	на.root-б-ива-ть-ся
краснота	красн.root-от-а
жирнейший	жир.root-н-ейш-ой
психогигиенический	псих.root-о-гигиен.root-ическ-ой
обираловка	о-бир.root-ал-овк-а	об-ир.root-ал-овк-а
хроматический	хром.root-ат-ическ-ой
гомеопат	гоме.root-о-пат.root
разлучница	раз-луч.root-ниц-а
выкидывание	вы-кид.root-ыва-ниj-о
нищенствовать	нищ.root-ен-ствова-ть
ежевика	еж.root-ив-ик-а	еже.root-в-ик-а
чухонский	чух.root-он-ск-ой
реньо	*реньо
грабеж	граб.root-еж
квартирник	квартир.root-ник
трясогузка	тряс.root-о-гуз.root-к-а
большо	больш.root-о
наслег	на-с-лег.root
божа	бож.root-а
забрюзжать	за-брюзж.root-а-ть
торговопромышленный	торг.root-ов-о-промышл.root-енн-ой
аахен	а-ах.root-ен
часослов	час.root-о-слов.root	ча.root-сослов.root
расистский	рас.root-ист-ск-ой	рас-ист.root-ск-ой
распространение	рас-про-стран.root-ениj-о
подоблачный	под-облач.root-н-ой
руль	руль.root
размах	раз-мах.root
гавань	гавань.root
бурелом	бур.root-ель-ом	бур.root-о-лом.root
наслаивать	на-сла.root-ива-ть
ноган	ног.root-ан
берсенев	бер.root-сен.root-ов	бер.root-сен.root-ев
вязочка	вяз.root-очк-а
полицай	полиц.root-ай
легализироваться	лег.root-ал-изирова-ть-ся
лазарев	лаз.root-ар-ев	лаз.root-арь-ев	лаз.root-арь-ов	лаз.root-ар-ов
альва	аль.root-в-а	а-льв.root-а
осипович	о-сип.root-ович
коллективизация	коллектив.root-ациj-а
етоты	*етоты
выдыхаться	вы-дых.root-а-ть-ся
прошибиться	про-шиб.root-и-ть-ся
фрикасе	*фрикасе
редак	редак.root
тришкин	три.root-шк-ин
пансырь	панс.root-ырь
хресьянский	*хресьянский
кранц	*кранц
привзвизг	при-вз-визг.root
мурья	мур.root-j-а
отговориться	от-говор.root-и-ть-ся
кимполунг	ки.root-м.root-пол-ун.root-г.root	ки.root-м.root-по-лун.root-г.root
обессмысливание	о-бес-с-мысл.root-ива-ниj-о
богопротивник	бог.root-о-против.root-ник
ореховица	орех.root-овиц-а
чуб	чуб.root
активнейший	акт.root-ивн-ейш-ой	актив.root-н-ейш-ой
самод	сам.root-од.root	с-а-мод.root
зверский	звер.root-ск-ой
комендантша	коменд.root-ант-ш-а
адэна	а-дэ.root-н-а	ад.root-эн.root-а
озимя	о-зим.root-а
перегорание	пере-гор.root-аниj-о
подножка	под-нож.root-к-а
съеживаться	с-еж.root-ива-ть-ся
совершенство	совершен.root-ств-о
наследить	на-след.root-и-ть
газ	газ.root
реставрация	реставр.root-ациj-а
переэкзаменовка	пере-экзамен.root-овк-а
покорень	по-корень.root
проживать	про-жив.root-а-ть	про-жи.root-ва-ть
одряхлеть	о-дрях.root-л-е-ть	о-дрях.root-ле.root-ть	одр.root-ах-л-е-ть
андро	андр.root-о
инпошив	ин.root-по-шив.root
петух	петух.root
гоми	го.root-ми.root	го.root-м.root-и	г.root-о-ми.root	г.root-о-м.root-и	г.root-ом.root-и
ухан	ух.root-ан	у-хан.root
герат	ге.root-ор-ат	ге.root-рат.root	г.root-ор-ат	г.root-о-рат.root	г.root-ер-ат
маячок	маяк.root-ок
скупочный	скуп.root-очн-ой
походочка	по-ход.root-очк-а
пароходо	пар.root-о-ход.root-о
молодая	молод.root-ая
протек	проте.root-к	про-тек.root
каолиновый	каолин.root-ов-ой
подушить	под.root-уш-и-ть	под-уш.root-и-ть	по-душ.root-и-ть	под-у-ши.root-ть
поглаживание	по-глаж.root-ива-ниj-о
крупорушка	круп.root-ор-ушк-а
лататы	лат.root-ат-ы
икнуть	ик.root-ну-ть
раскопочный	рас-коп.root-очн-ой
опровергаться	о-про-верг.root-а-ть-ся
противосамолетный	противо-сам.root-о-лет.root-н-ой
ножонка	нож.root-онк-а
грешок	греш.root-ок
барс	барс.root
успокоиться	у-споко.root-и-ть-ся
нью-мексико	нью.root-мек.root-с-ик-о
суетня	сует.root-н-а
всполошный	вс-полош.root-н-ой
редупликация	ре-дупл.root-ик-ациj-а
презус	п.root-рез.root-ус.root
интенсивность	интенсив.root-ность
блямс	*блямс
бояр	бояр.root
василье	васил.root-j-о
глечик	гле.root-чик
самоходка	сам.root-о-ход.root-к-а
тягучесть	тяг.root-уч-е-сть
косатик	косат.root-ик
отрицатель	от-риц.root-а-тель	от-риц.root-ат-ель
мантуя	ман.root-ту.root-а	мант.root-у.root-а
разгуляй	раз-гул.root-яй	раз-гул.root-ай
псевдоморфоза	псевд.root-о-морф.root-оз-а
разъединый	раз-един.root-ой
монументальность	мо.root-ну-мент-альн-ость	мон.root-у-мент-альн-ость
рогаль	рог.root-аль
пильзенский	пиль.root-зен.root-ск-ой	пиль.root-зе.root-нск-ой
великодержавие	велик.root-о-держав.root-иj-о
позарез	поза-рез.root
коррелат	кор.root-ре-лат.root
изложня	из-ложн.root-а
ламповая	ламп.root-ов-ая
барт	*барт
южнославянский	юж.root-н-о-слав.root-янск-ой	юж.root-н-о-славян.root-ск-ой
фракционировать	фракци.root-он-ирова-ть
зарплата	зар.root-плат.root-а
отобразить	от-образ.root-и-ть
ташский	таш.root-ск-ой
геническ	ге.root-ник-е-с-к	ген.root-ич-е-с-к        ! хпш
контрастировать	контраст.root-ирова-ть
мультисплит	мульти.root-сплит.root
косточковый	кост.root-очк-ов-ой
оформление	о-формл.root-ениj-о
ханжеский	ханж.root-еск-ой
кумарный	кум.root-арн-ой
хорьха	*хорьха
разрастись	раз-рас.root-ти-ся	раз-ра.root-сти-ся
лост	ло.root-ст.root        ! хпш
неприметный	не-прим.root-от-н-ой	не-при-мет.root-н-ой	не-прим.root-ет-н-ой
общеизвестность	общ.root-о-извест.root-ность
пульсовый	пульс.root-ов-ой
девайс	*девайс
разделывание	раз-дел.root-ыва-ниj-о
медиастинальный	медиа.root-с-тин.root-альн-ой	мед.root-и-аст-ин-альн-ой	медиа.root-сти.root-н-альн-ой	мед.root-иj-аст-ин-альн-ой	медиа.root-ст.root-ин-альн-ой
нефтеэкспортер	нефт.root-о-экспорт.root-ор	нефт.root-о-экспорт.root-ер
перепроверяться	пере-про-вер.root-а-ть-ся
биз	*биз
рудинштейн	*рудинштейн
листовский	лист.root-овск-ой
взбугриться	вз-бугр.root-и-ть-ся
навыпуск	на-вы-пуск.root
беконный	*беконный
кодекс	*кодекс
сальвадорский	саль.root-вад.root-ор-ск-ой     ! имя
пазогребневой	паз.root-о-гр.root-ебн-ев-ой	паз.root-о-греб.root-н-ев-ой
раскритиковать	рас-критик.root-ова-ть
фторид	фтор.root-ид.root      ! спец. слово
приблуд	при-блуд.root
снегоочистительный	снег.root-о-о-чист.root-ительн-ой
кубрак	куб.root-рак.root	ку.root-брак.root      ! нет в словаре
стейк	с-тей.root-к	ст.root-ей-к     ! нет в словаре
фибра	фибр.root-а
подвигать	по-двиг.root-а-ть
партгосаппарат	парт.root-гос.root-аппарат.root
лохматить	лохм.root-ат-и-ть
ставочка	став.root-очк-а
димекарбин	*димекарбин
оттачиваться	от-тач.root-ива-ть-ся
помышлять	по-мышл.root-а-ть
противокорабельный	противо-корабель.root-н-ой	противо-кор.root-абельн-ой
кмса	*кмса
инсигния	ин.root-сигн.root-иj-а	ин.root-с-игни.root-а	ин.root-сиг.root-ниj-а      ! имя
консорт	кон.root-сорт.root      ! нет в словаре
скотобаза	скот.root-о-баз.root-а
ракопаук	рак.root-о-паук.root
шлемовидный	шлем.root-о-вид.root-н-ой
темноокрашенный	темн.root-о-о-краш.root-енн-ой
аграфия	а-граф.root-иj-а      ! имя
конструктор	конструк.root-тор
посадка	пос.root-ад-к-а
крематорий	кремат.root-орий
копейченко	*копейченко
впечатлиться	в-печат.root-ли.root-ть-ся	в-печат.root-л-и-ть-ся
двухкилограммовый	двух.root-кило.root-грамм.root-ов-ой	двух.root-кил.root-о-грамм.root-ов-ой
крынка	крын.root-к-а
вирулицидный	вир.root-у-лиц.root-ид.root-н-ой	вир.root-у-ли.root-цид.root-н-ой	в-ир-у-лиц.root-ид.root-н-ой	в-ир-у-ли.root-цид.root-н-ой      ! спец. слово
палисандр	па-лис.root-андр.root     ! нет в словаре
дегуманизация	де-гум.root-ан-ациj-а
рдест	рд.root-ест.root	рд.root-о-ст.root      ! хпш
мерительный	мер.root-ительн-ой
младенцев	млад.root-ен-ц-ов	млад.root-ен-ц-ев     ! имя
ирини	ир.root-ин-и	ир-ин.root-и     ! хпш
прошивной	прош.root-ивн-ой
доделываться	до-дел.root-ыва-ть-ся
реваншист	реванш.root-ист
дусечка	дус.root-ечк-а      ! имя
ребзя	*ребзя
фск	*фск
полиакриламидный	поли.root-а-кри.root-лам.root-ид.root-н-ой       ! спец. слово
етм	*етм
счетно-решающий	счет.root-н-о-реш.root-а-ющ-ой
ручеек	руч.root-о-ек.root
вынуть	вы-ø-ну-ть
коллективность	коллектив.root-ность
футеровка	футер.root-овк-а
фолос	фол.root-ос.root    ! хпш
дотянуться	до.root-т-ану-ть-ся	до-тян.root-у-ть-ся
путинизм	пут.root-ин-изм    ! имя
шпильман	шпиль.root-ман
босфор	бос.root-фор.root      ! имя
мгок	мг.root-ок     ! хпш
малозначимый	мал.root-о-знач.root-им-ой	мал.root-озн-ач-им-ой
племяш	плем.root-аш	плем.root-яш
погубительница	по-губ.root-итель-ниц-а
гтк	г.root-тк.root      ! хпш
коника	кон.root-ик-а    ! хпш
сверхобычный	сверх-обыч.root-н-ой
зарубцовываться	за-руб.root-ц-ов-ыва-ть-ся
малоразмерный	мал.root-о-размер.root-н-ой
шприцевать	*шприцевать
инжекторный	ин.root-же.root-к-тор-н-ой      ! спец. слово
залежный	зал.root-о-жн.root-ой	зал.root-еж-н-ой	за-леж.root-н-ой
тридцатипятилетие	три.root-дцати.root-пяти.root-лет.root-иj-о	три.root-дцати.root-пяти.root-ле.root-тиj-о	три.root-дцати.root-пят.root-ил-е-тиj-о	три.root-дцати.root-пяти.root-л-е-тиj-о
рентгенотомографический	рентген.root-о-том.root-о-граф.root-ическ-ой
многобожие	мног.root-о-бож.root-иj-о
манихеец	ман.root-их-е-ец     ! имя
заторчать	за-торч.root-а-ть
биоптрон	био.root-пт.root-рон.root	би.root-опт.root-рон.root	био.root-п.root-трон.root	би.root-о-пт.root-рон.root	би.root-о-п.root-трон.root    ! хпш
буквочки	букв.root-очк-и
дейтерий	дей.root-тер.root-ой     ! нет в словаре
риэлтерский	*риэлтерский
антигосударственный	анти-государ.root-ственн-ой
пятидесятник	пяти.root-десят.root-ник	пяти.root-дес.root-ятник
мультидивизиональный	мульти.root-дивизи.root-он-альн-ой
лущить	лущ.root-и-ть
герметизировать	гермет.root-изирова-ть
бутер	бут.root-ер	бут.root-ор
неопреновый	не-о-пре-нов.root-ой	не.root-о-пре-нов.root-ой	нео.root-пре-нов.root-ой     ! спец. слово
белков	бел.root-к-ов	бел.root-ков.root      ! имя
прокламация	про-клам.root-ациj-а
герл	ге.root-ор-л	г.root-ор-л	г.root-ер-л     ! хпш
свиль	с-виль.root     ! хпш
эротичность	эрот.root-ичн-ость
подотряд	под-от-ряд.root
васюковский	в-а-сю.root-к-овск-ой     ! имя
антисоциалистический	анти-социал.root-истическ-ой
понимас	*понимас
балтимор	балт.root-имо.root-ор	балт.root-им.root-ор	бал.root-тим.root-ор      ! имя
алазани	а-лаз.root-а-н-и	а-лаз.root-ан.root-и     ! имя
форматировать	формат.root-ирова-ть
вамп	в-ам.root-п.root     ! хпш
унн	ун.root-н     ! хпш
либрария	либр.root-а-ри.root-а      ! хпш
пемоксоль	п.root-о-мок.root-соль.root	пе.root-мок.root-соль.root      ! спец. слово
джебра	*джебра
митрить	митр.root-и-ть
эмг	*эмг
наседка	на-сед.root-к-а
аек	а-ек.root   ! хпш
низинка	низ.root-инк-а
непатентованный	не-патент.root-о-ванн.root-ой
дристать	др.root-ист-а-ть   ! хпш
очаровательный	о-чар.root-ова-тельн-ой
перфектив	перфект.root-ив
мир	мир.root
мультизональный	мульти.root-зон.root-альн-ой
безвирусный	без-вирус.root-н-ой
порубочный	по-руб.root-очн-ой
дгцсэн	*дгцсэн
раздевалка	раз-дев.root-ал-к-а    ! ошибка
парашютный	парашют.root-н-ой
лакирование	лак.root-ир-ованиj-о
керогаз	кер.root-о-газ.root
ицы	и.root-ц-ы    ! хпш
одеялка	одеял.root-к-а
отдирание	от-дир.root-аниj-о
малокозырка	мал.root-о-козыр.root-к-а
конкиста	конкист.root-а
разведы	раз-вед.root-ы
застраховаться	за-страх.root-ова-ть-ся
сопение	соп.root-ениj-о
сбраживание	с-браж.root-ива-ниj-о
партбюрократия	парт.root-бюрократ.root-иj-а
пузырик	пузыр.root-ик
непорочность	не-пор.root-очн-ость	не-по-роч.root-ность
поддакивание	под-да.root-кив.root-аниj-о	под-да.root-к-ива-ниj-о
приснодева	присн.root-о-дев.root-а
ежки	еж.root-к-и
акселератка	ак.root-сел.root-о-рат.root-к-а	ак.root-сел.root-ор-ат-к-а	ак.root-сел.root-ер-ат-к-а     ! хпш
махровость	махр.root-ов-ость	махр.root-о-во.root-сть	махр.root-ово.root-сть
отсоединять	от-соедин.root-а-ть
протурецкий	про-тур.root-ецк-ой
секущий	сек.root-ущ-ой
записчик	зап.root-ис-чик
телогреечка	тело.root-гре.root-ечк-а	тел.root-о-гре.root-ечк-а
пристроиться	при-стро.root-и-ть-ся
волоснить	волос.root-ни.root-ть	волос.root-н-и-ть	во-лосн.root-и-ть	волос.root-нить.root
жвирблис	жв.root-ир.root-бл.root-ис.root    ! хпш
охотбилет	охот.root-билет.root
щекотно	щекот.root-н-о
дисфункция	дис-функц.root-иj-а
бендеры	бен.root-де-ры.root     ! имя
африкаанс	африк.root-а-анс      ! имя
затменье	за-тм.root-ениj-о
клиппер	кл.root-и.root-п.root-пер.root      ! нет в словаре
новоканонизированный	нов.root-о-канон.root-из-ированн-ой
затайка	зат.root-ай-к-а	за-тай.root-к-а
лебедиха	лебед.root-их-а
пропитывание	про-пит.root-ыва-ниj-о	проп.root-ит-ыва-ниj-о
пигмейский	п.root-иг.root-ме.root-йск-ой	пи.root-г.root-ме.root-йск-ой	п.root-иг.root-м.root-ейск-ой	пи.root-г.root-м.root-ейск-ой      ! нет в словаре
янов	я.root-нов.root	я.root-н-ов      ! хпш
калвин	кал.root-в-ин	кал.root-вин.root    ! имя
наглейший	нагл.root-ейш-ой
релихт	*релихт
чарджуйский	*чарджуйский
безотложный	без-от-ложн.root-ой
фальшивый	фальш.root-ив-ой
глобок	г.root-лобок.root      ! хпш
шнырнуть	шныр.root-ну-ть
сбитый	с-бит.root-ой
лейкоцитоз	лейк.root-о-цит.root-оз
разливочный	раз-лив.root-очн-ой
копчиковый	коп.root-чик-ов-ой	копч.root-ик-ов-ой
мудрить	мудр.root-и-ть
укус	у-кус.root
мембранотропный	мембран.root-о-троп.root-н-ой
азарова	а-за-рова.root	а-за-ров.root-а      ! имя
милиционерша	ми.root-лиц.root-ион-ер-ш-а      ! нет в словаре
нато	нат.root-о
пронаблюдать	про-на-блюд.root-а-ть
таврить	тавр.root-и-ть
марэ	*марэ
видеоинженер	видео.root-инженер.root
амфиболит	амфиб.root-о-лит.root
бормашина	бор.root-машин.root-а
картофелеводство	картофел.root-о-вод.root-ств-о
вычерчивать	вы-черч.root-ива-ть
сронить	ср.root-о-ни.root-ть	с-рон.root-и-ть	ср.root-о-нить.root	ср.root-он-и-ть
темно-фиолетовый	темн.root-о-фиолет.root-ов-ой
отшатнуться	от-шат.root-ну-ть-ся
аллергология	аллерго.root-л-о-ги.root-а	аллерг.root-о-лог.root-иj-а	аллерго.root-лог.root-иj-а
синдицировать	син.root-д-иц-ирова-ть    ! хпш
звеньевой	зв.root-ень-ев-ой	звен.root-j-ев-ой	зв.root-ениj-ев-ой
мыть	мы.root-ть
незахороненный	не-за-хорон.root-енн-ой
топорность	топор.root-ность
каська	кас.root-j-к-а     ! имя
джезказган	*джезказган
пречистенка	преч.root-ист-енк-а       ! имя
рассказать	рас-сказ.root-а-ть
усема	у-сем.root-а	у-сема.root      ! хпш
плетневский	плет.root-н-евск-ой
нетревожный	не-тревож.root-н-ой
тормоз	тормоз.root
отсидка	от-сид.root-к-а
рамат	рам.root-ат     ! хпш
потопить	пот.root-о-пи.root-ть	по-топ.root-и-ть	пот.root-опи.root-ть
зубопротезирование	зуб.root-о-протез.root-ир-ованиj-о
сватья	сват.root-j-а
мышелов	мыш.root-ель-ов	мыш.root-о-лов.root
памятливый	памят.root-лив-ой
предвозрождение	пред-воз-рожд.root-ениj-о
бизантийский	*бизантийский
смычок	с-мыч.root-ок
танкошлем	танк.root-о-шлем.root
упитанный	у-пит.root-ан-н-ой
ахтубинский	ах.root-туб.root-инск-ой      ! имя
импликатура	им-пликат.root-ур-а	им-плик.root-атур-а
каравелла	кар.root-а-вел.root-л-а     ! нет в словаре
самовластительный	сам.root-о-власт.root-ительн-ой
ордовикский	орд.root-овик-ск-ой     ! нет в словаре
исламов	ислам.root-ов
вирусный	вирус.root-н-ой
италия	итал.root-иj-а
хорканье	хор.root-ка-ниj-о
файтер	*файтер
заскорузлый	за-скор.root-уз-л-ой	за-скор.root-узл.root-ой
рудопроявление	руд.root-о-про-явл.root-ениj-о
устроенность	у-стро.root-е-нность	у-стро.root-ен-ность	у-стро.root-енн-ость
белл	бел.root-л     ! имя
кутепов	ку.root-теп.root-ов	кут.root-о-п.root-ов      ! имя
антрекот	ан.root-трек.root-от     ! нет в словаре
обрастать	об-рас-та.root-ть	об-раст.root-а-ть
дебильно	де-би.root-ль-н-о      ! нет в словаре
стилять	стил.root-а-ть
подмешивание	под-меш.root-ива-ниj-о
дюшаны	*дюшаны
планарный	план.root-арн-ой
неформализованный	не-форм.root-ал-изова-н-н-ой
балабонить	бал.root-а-бо.root-нить.root	бал.root-а-бо.root-ни.root-ть	бал.root-а-бо.root-н-и-ть
корела	кор.root-е-л-а	кор.root-о-ла.root	кор.root-ел.root-а   ! имя
тумблер	тумб.root-ле.root-ор	тумб.root-л-е-ор       ! имя
вперекор	в-перек.root-ор	в-пере-кор.root      ! ошибка
академия	академ.root-иj-а
командование	команд.root-ованиj-о
предстоящий	пред-сто.root-ящ-ой
ссылкакак	с-сыл.root-как.root-ак    ! хпш
араканец	а-ра.root-ка-нец	а-рак.root-а-нец	а-рак.root-ан-ец   ! имя
доходчиво	до-ход.root-чив.root-о	дох.root-о-дч.root-ив-о      ! ошибка
майло	май.root-л-о      ! имя
целительница	цел.root-итель-ниц-а
астафьевский	а-с-таф.root-j-евск-ой   ! имя
рыковка	рык.root-овк-а
макистерон	мак.root-ист-о-рон.root    ! хпш
димитровский	*димитровский
треугольный	тре.root-уголь.root-н-ой
потрошеный	потрош.root-ен-ой
интолерантность	ин.root-тол.root-ер-ант-н-ость	ин.root-тол.root-о-рант.root-ность	ин.root-тол.root-ор-ант-н-ость
метание	мета.root-ниj-о	мет.root-аниj-о
фэи	*фэи
поколенческий	по-колен.root-ческ-ой
довестись	до-ве.root-сти-ся	до-вес.root-ти-ся
двухступенчатый	двух.root-ступен.root-чат-ой
таксер	такс.root-ор	такс.root-ер
радиофизический	ради.root-о-физи.root-ческ-ой	радио.root-физи.root-ческ-ой	радио.root-физ.root-ическ-ой	ради.root-о-физ.root-ическ-ой
крючконосый	крюч.root-к-о-нос.root-ой
шитолицый	ши.root-т-о-лиц.root-ой
скиба	с-ки.root-б-а   ! имя
заведование	за-вед.root-ованиj-о
прокоммунистический	про-коммун.root-истическ-ой
уважительность	уваж.root-ительн-ость
терминал	терм.root-ин.root-ал	тер.root-мин.root-ал
прибрежье	при-брежь.root-о
мужний	муж.root-н-ой
понимаш	пон.root-им-аш	по-ним.root-аш     ! хпш
стращать	стращ.root-а-ть
неразумный	не-разум.root-н-ой
золотоноша	золот.root-о-нош.root-а
высокоинтеллектуальный	высок.root-о-интеллект.root-уальн-ой
культуральность	культур.root-альн-ость
учение	уч.root-ениj-о
девадаси	дев.root-ад-а-с-и	де-вад.root-а-с-и      ! имя
лагерек	лаг.root-о-рек.root	лагер.root-ек.root	лагер.root-еj-к
уханов	у-хан.root-ов	ух.root-ан-ов      ! имя
сейсмичность	сейсм.root-ичн-ость
внештатный	вне-штат.root-н-ой
полузвук	пол-у-звук.root
битум	бит.root-ум     ! нет в словаре
косматый	косм.root-ат-ый	косм.root-ат-ой
татами	тат.root-ам.root-и	та.root-там.root-и      ! нет в словаре
храпоидол	храп.root-о-идол.root
текстовый	текст.root-ов-ой
отмирание	от-мир.root-аниj-о
юкка	*юкка
неколебимость	не-колеб.root-имость
иам	и.root-ам.root      ! хпш
водонагреватель	вод.root-о-на-гре.root-ва-тель	вод.root-о-наг.root-ор-еват-ель	во-до-на-грев.root-а-тель	вод.root-о-наг.root-ор-ева-тель	во-до-наг.root-ор-ева-тель	во-до-на-гр.root-ева-тель	во-дон.root-агр.root-еват-ель	вод.root-о-на-гр.root-еват-ель	вод.root-о-на-гр.root-ева-тель	вод.root-о-на-грев.root-а-тель	во-дон.root-агр.root-ева-тель	во-до-на-грев.root-ат-ель	во-до-на-гре.root-ва-тель	во-до-на-гр.root-еват-ель	во-до-наг.root-ор-еват-ель	вод.root-о-на-грев.root-ат-ель
сдирать	с-дир.root-а-ть
скептично	*скептично
трихомонадный	*трихомонадный
оладушка	олад.root-ушк-а
синарский	син.root-арь-ск-ой	син.root-ар-ск-ой      ! имя
шваркнуть	шварк.root-ну-ть
коктейльный	коктейль.root-н-ой
кластер	класт.root-ор	класт.root-ер
напрочь	на-про.root-чь	на-прочь.root
поржаветь	по-ржав.root-е-ть
челочка	чел.root-очк-а
кепс	*кепс
блекнуть	блек.root-ну-ть
суперкомпьютерный	супер-ком.root-пь.root-ют.root-ор-н-ой	супер-ком.root-пь.root-ют.root-ер-н-ой
экранолет	экран.root-о-лет.root
биосинтез	био.root-син.root-тез.root	би.root-о-син.root-тез.root	би.root-осин.root-тез.root
водовоз	вод.root-о-воз.root	во-до-воз.root
кунстхалл	кун.root-ст.root-хал.root-л	кун.root-с-тх.root-ал-л     ! хпш
мао	ма.root-о     ! имя
квартиренок	квартир.root-ен-ок	квартир.root-о-нок.root
мингосимущество	мин.root-гос.root-им-ущ-еств-о
соллерс	*соллерс
однопользовательский	одн.root-о-польз.root-ова-тельск-ой
хейсока	*хейсока
карабканье	карабк.root-а-ниj-о	карабк.root-ан-j-о
проституировать	про-сти.root-ту.root-ирова-ть     ! нет в словаре
сорос	со-рос.root     ! имя
шалить	шал.root-и-ть
по-купечески	по-куп.root-о-чес.root-к-и
шеститомник	шести.root-том.root-ник
билингвизм	би.root-лингв.root-изм
пилотирование	пил.root-о-тир.root-ованиj-о	пил.root-от-ирова-ниj-о
нагайбак	наг.root-ай.root-бак.root      ! имя
увк	у.root-в-к      ! хпш
диагносцировать	диагн.root-ос.root-ц-ирова-ть     ! ошибка
ведерочко	ведер.root-очк-о
противоречивый	противо-ре-чив.root-ой	противо-ре.root-чив-ой	противо-реч.root-ив-ой
пшенка	пшен.root-к-а
частить	част.root-и-ть
фенильный	фен.root-ильн-ой      ! спец. слово
углепластика	угл.root-о-пласт.root-ик-а
тайник	тайн.root-ик	тай.root-ник
гавриц	гав.root-риц.root        ! имя
период	пе.root-ри.root-од.root	пер.root-и.root-од.root	п.root-о-ри.root-од.root
муравей	мурав.root-ей
оксид	ок.root-сид.root      ! спец. слово
чужачка	чуж.root-ачк-а
боксинг	бокс.root-инг
разрядность	раз-ряд.root-ность
пятилисточковый	пят.root-ил-ист-очк-ов-ой     ! ошибка
неброский	не-брос.root-к-ой	не-брос.root-кий.root
схиигумен	*схиигумен
юльсипупия	*юльсипупия
протаранить	про-таран.root-и-ть
рационалистический	рац.root-ион.root-ал-истическ-ой	рацио.root-на-лист.root-ическ-ой	рацио.root-на.root-л-истическ-ой	рацио.root-н-а-л-истическ-ой	рац.root-ион-а-л-истическ-ой
досмеяться	до-сме.root-а-ть-ся
плет	плет.root
томилино	том.root-ил-ин-о     ! имя
лагода	лаг.root-од.root-а	лаг.root-о-да.root	ла.root-год.root-а     ! имя
зилка	*зилка
насказать	на-сказ.root-а-ть
подзабыть	под-забы.root-ть
онтологизация	онто.root-лог.root-ациj-а	онт.root-о-лог.root-ациj-а
угрюмство	угрюм.root-ств-о
ляшок	*ляшок
взъярить	вз-яр.root-и-ть
полоролев	пол.root-о-рол.root-ев	пол-ор.root-ол-ев	пол-о-рол.root-ов	пол-ор.root-ол-ов	пол.root-о-рол.root-ов	пол-о-рол.root-ев	пол-ор.root-о-лев.root      ! имя
фасонить	фасон.root-и-ть
хела	*хела
запрессовывать	за-пресс.root-ов-ыва-ть
четырехбуквенный	четырех.root-букв.root-енн-ой
спрей	с-пр.root-ей	сп.root-рей.root     ! нет в словаре
ниспровергаться	ни.root-с-про-верг.root-а-ть-ся     ! ошибка
нев	*нев
неприемный	не-при-ем.root-н-ой
мелковатый	мелк.root-оват-ой
телесеть	теле.root-сеть.root	теле.root-с-е-ть	теле.root-се.root-ть	тел.root-о-се.root-ть	тел.root-о-сеть.root
биотехнический	биот.root-ох-н-ическ-ой	би.root-о-тех.root-ническ-ой	би.root-о-техн.root-ическ-ой	био.root-тех.root-ническ-ой	био.root-техн.root-ическ-ой
сквозной	сквоз.root-н-ой
смертоубийство	смерт.root-о-у-бий.root-ств-о
гаспаров	гас.root-пар.root-ов	гас.root-па-ров.root      ! имя
антисталинизм	анти-стал.root-ин-изм     ! имя
клещевой	клещ.root-ев-ой
ильюшинцев	иль.root-уш-ин-ц-ов	иль.root-уш-ин-ц-ев      ! имя
скачкообразность	скач.root-к-о-образ.root-ность
невообразимость	не-во-образ.root-имость
подсуетиться	под-су.root-от-и-ть-ся	под-су.root-ет-и-ть-ся	под-суе.root-т-и-ть-ся
незатопленный	не-за-топл.root-енн-ой
лакрима	лак.root-рим.root-а     ! имя
химсостав	хим.root-со-став.root
мазепин	маз.root-о-пин.root     ! имя
паразитол	паразит.root-ол
рюрик	*рюрик
тишать	тиш.root-а-ть
неискупленный	не-ис-купл.root-енн-ой
верхнедевонский	верх.root-н-о-дев.root-он-ск-ой	верх.root-не-дев.root-он-ск-ой	верх.root-не-де-во.root-нск-ой	верх.root-не-де-вон.root-ск-ой      ! спец. слово
выцветший	вы-цвет.root-ш-ой
канн	кан.root-н     ! имя
беломестный	бел.root-о-мест.root-н-ой
гар	гар.root
жок	*жок
окутаться	о-кут.root-а-ть-ся	ок.root-ут-а-ть-ся
экспромт	*экспромт
уваривать	у-вар.root-ива-ть	у-вари.root-ва-ть
электронно-механический	электрон.root-н-о-механ.root-ическ-ой	электр.root-онн-о-механ.root-ическ-ой
такырной	*такырной
несчастность	не-счаст.root-ность
разрешимость	раз-реш.root-имость
фигушка	фиг.root-ушк-а
кальдера	каль.root-де-ра.root     ! имя
графитный	граф.root-ит-н-ой
бондарев	бондар.root-ев	бондар.root-ов      ! имя
люмпен-пролетарий	люмпен.root-пролетар.root-ой
энкаведешник	эн.root-ка.root-вед.root-ешн-ик	эн.root-ка.root-вед.root-еj-ш-ник	эн.root-к-ав-о-де.root-ш-ник	эн.root-к-ав-о-де.root-шн-ик      ! хпш
егэ	*егэ
нерожденный	не-рожд.root-енн-ой
чинар	чин.root-арь	чин.root-ар      ! нет в словаре
культивирование	культ.root-ив-ирова-ниj-о
кохлеарный	*кохлеарный
авиамоторный	авиа.root-мотор.root-н-ой	авиа.root-мот.root-орн-ой
мезосфера	мез.root-о-сфер.root-а	мезо.root-сфер.root-а
триз	*триз
зарисовываться	за-рис.root-ов-ыва-ть-ся	зар.root-ис-ов-ыва-ть-ся
этнополитология	этн.root-о-полит.root-о-лог.root-иj-а
кудель	кудель.root
радзивилловский	*радзивилловский
усыновление	у-сын.root-о-вл.root-ениj-о	у-сын.root-о-вле.root-ниj-о	у-сы.root-новл.root-ениj-о
приляпать	при-ляп.root-а-ть
баграмский	багр.root-ам.root-ск-ой      ! имя
общестроительный	общ.root-о-стро.root-ительн-ой
фноа	*фноа
боговидение	бог.root-о-вид.root-ениj-о
раздутый	раз-дут.root-ой
мопед	м.root-о-п.root-ед.root	мо.root-п.root-ед.root      ! нет в словаре
помирать	по-мир.root-а-ть	пом.root-ир-а-ть
прожилина	про-жил.root-ин-а
моксель	мок.root-сель.root    ! хпш
нишеть	ни.root-ш-е-ть	ни.root-ше.root-ть      ! хпш
выкатить	выкат.root-и-ть
дегероизировать	де-геро.root-изирова-ть
сцеловывать	с-целов.root-ыва-ть
нефтянка	нефт.root-янк-а	нефт.root-анк-а
ганглий	ганглий.root
омутище	ом.root-ут-ищ-о
замутнить	за-мут.root-н-и-ть	зам.root-ут-н-и-ть	за-мут.root-нить.root	за-мут.root-ни.root-ть
медиатор	медиа.root-тор
знакомство	знаком.root-ств-о
вийна	*вийна
страховаться	страх.root-ова-ть-ся
волкова	волк.root-ов.root-а	вол.root-ков.root-а     ! имя
стоход	сто.root-ход.root	ст.root-о-ход.root
разобщенно	раз-общ.root-ен-н-о
экспансионизм	экс-панс.root-ион-изм   ! нет в словаре
татра	та.root-тра.root	тат.root-ра.root     ! хпш
папий	пап.root-ой     ! хпш
сексодром	секс.root-о-дром.root
отбушевать	от-буш.root-ева-ть
негордый	не-горд.root-ой
ммо	м.root-м.root-о	м.root-мо.root        ! хпш
многочтимый	мног.root-о-чт.root-им-ой
лимфоузел	лимф.root-о-у-зел.root
кидаться	кид.root-а-ть-ся
скомпилировать	с-компил.root-ирова-ть
дознаватель	до-зна.root-ва-тель
бавария	бав.root-а-ри.root-а      ! имя
хайтэк	*хайтэк
зачехлить	за-чехл.root-и-ть
неутратить	не-у-трат.root-и-ть
фрахтование	фрахт.root-ованиj-о
биосфера	би.root-о-сфер.root-а	био.root-сфер.root-а
визаж	виз.root-аж
соляночка	сол.root-ан-очк-а	сол.root-янк-к-а
полещик	пол.root-еj-щик     ! хпш
нерассеянный	не-рас-се.root-янн-ой
раскассировать	рас-касс.root-ирова-ть
умляут	умл.root-я.root-ут.root      ! хпш
умничек	ум.root-нич.root-еj-к	ум.root-нич.root-ек.root	ум.root-ни.root-чек.root     ! хпш
нервоз	нерв.root-оз
внутринаучный	внутри-науч.root-н-ой
раздолбать	раз-долб.root-а-ть
хризантема	хриз.root-ан.root-тем.root-а     ! нет в словаре
