перезагрузка	пере-за-груз.root-к-а
воздыхиватель	воз-дых.root-ива-тель
забивание	за-бив.root-аниj-о
забегание	за-бег.root-аниj-о
воздухоплаватель	воздух.root-о-пла.root-ва-тель
грибология	гриб.root-о-лог.root-иj-а
блюстительница	блюст.root-ительн-иц-а	блюст.root-и-тельниц-а	блюст.root-итель-ниц-а	блюст.root-и-тельн-иц-а	блюст.root-и-тель-ниц-а
будочник	будоч.root-ник
валик	вал.root-ик	вали.root-к
вареник	вар.root-еник
водоросль	во-до-рас-ль.root	вод.root-о-рос.root-ль	во-до-рос.root-ль
непереносимость	не-пере-нос.root-имость
недоросль	недо-рас-ль.root	недо-рос.root-ль
врун	вр.root-ун	в-рун.root
пекарь	пек.root-арь
точило	точ.root-ил-о
покрывало	по-кры.root-ва-л-о	по-крыв.root-ал.root-о	по-крыв.root-а-л-о	по-кры.root-вал.root-о	по-крыв.root-ал-о
скандинавка	скандинав.root-к-а
еврейка	еврей.root-к-а
бедняжечка	бедн.root-аж-ечк-а
развалюха	раз-вал.root-ух-а
растеряша	раст.root-о-ряш.root-а
воображуля	во-об-раж.root-ул-а	во-о-браж.root-уль-а	во-об-раж.root-уль-а	во.root-о-браж.root-уль-а	во.root-о-браж.root-ул-а	во-о-браж.root-ул-а
препятствие	пре-пят.root-ствиj-о
развитие	раз-вити.root-о
репродукция	ре-продукц.root-иj-а
вмешательство	в-меш.root-а-тельств-о	в-меш.root-а-тель-ств-о
доказательство	до-казат.root-ель-ств-о	до-каз.root-а-тельств-о	до-каз.root-а-тель-ств-о
болтовня	болт.root-овн-а
весна	весн.root-а
глоток	глот.root-ок
мазок	маз.root-ок
бытность	быт.root-ность	быт.root-н-ость
отзовизм	от-зов.root-изм
удача	удач.root-а
отдача	от-дач.root-а
метель	мете.root-ль	мет.root-ель	ме.root-тель
нелегальщина	не-легаль.root-щин-а
поденщина	по-ден.root-щин-а	под.root-ен-щин-а
безвкусица	без-вкус.root-иц-а
духота	дух.root-от-а
широта	шир.root-от-а
доброта	добр.root-от-а
новизна	нов.root-изн-а
желтизна	желт.root-изн-а
толщина	тол.root-щин-а	толщ.root-ин-а
глубина	глуб.root-ин-а
сырца	сыр.root-ц-а
полдник	полд.root-ник
полярник	поляр.root-ник	пол.root-ярник
моряк	мор.root-як	мор.root-ак
сибиряк	сибир.root-як	сибир.root-ак
музыкант	музык.root-ант
пепелище	пепел.root-ищ-о
паутина	паут.root-ин-а
энергетика	энергет.root-ик-а
директорат	директор.root-ат
квадратура	квадрат.root-ур-а
олимпиадница	о-ли.root-м.root-пи.root-ад-ниц-а	о-ли.root-м.root-п.root-иад-ниц-а
раскадровка	рас-кадр.root-овк-а
туберкулёзница	туберкул.root-оз-ниц-а
планетарий	планет.root-арий
лесничий	лес.root-нич-ий
верхушка	верх.root-ушк-а
городничиха	город.root-ник-их-а
котёнок	кот.root-онок
беглец	бег.root-лец
железяка	желез.root-ак-а	желез.root-як-а
рыбёшка	рыб.root-ёшк-а
пьянчужка	пьян.root-чуж.root-к-а
антимужчина	анти-муж.root-чин-а
экс-король	экс-король.root
субпериод	суб-пер.root-и.root-од.root	суб-пе.root-ри.root-од.root	суб-п.root-о-ри.root-од.root
суперобложка	супер-об-ложк.root-а
радиационный	ради.root-ационн-ой
крохотный	крох.root-отн-ой
портняжный	порт.root-няк-н-ой	порт.root-н-яжн-ой
смертельный	смерт.root-ельн-ой
кожаный	кож.root-ан-ой
глиняный	глин.root-ян-ой
апельсиновый	а-пель.root-син.root-ов-ой	а-пель.root-с-ин-ов-ой
путейский	пут.root-ейск-ой
королевский	корол.root-евск-ой
горбатый	горб.root-ат-ой	горб.root-ат-ый
жалостливый	жал.root-ост-лив-ой
дырявый	дыр.root-яв-ой
годовалый	год.root-ова-л-ой	год.root-о-вал.root-ой	год.root-овал.root-ой
швейный	швей.root-н-ой
удовлетворительный	удовлетвор.root-ительн-ой	удовлетвор.root-и-тельн-ой
достижимый	до-стиж.root-им-ой
переливчатый	пере-лив.root-чат-ой
ходячий	ход.root-яч-ой
плавучий	п.root-лав.root-уч-ой	пл.root-ав-у-ч-ой	пла.root-в-у-ч-ой
влюбчивый	в-люб.root-чив-ой
спелый	спел.root-ой
крытый	крыт.root-ой
мятый	мят.root-ой
старейший	стар.root-ейш-ой
наигорячейшие	наи-гор.root-ячей.root-ши.root-о	на-игор.root-ячей.root-ши.root-о
худощавый	худ.root-ощав-ой
давнишний	давн.root-ишн-ой
дооборудовать	до-обо-руд.root-ова-ть	до-об-оруд.root-ова-ть
недоиспользовать	недо-ис-польз.root-ова-ть
перерасходовать	пере-рас-ход.root-ова-ть
антиокислитель	анти-о-кисл.root-итель	анти-о-кисл.root-и-тель
малюсенький	мал.root-юсеньк-ой
душегубка	душ.root-о-губ.root-к-а
